             -------~
             |      |
           ~---~    |
          /     \   |
          \     /   |
         __-----__  |
        / /|   |\ \ |
        |_||   ||_| |
           |___|    |
             \ \    |
              | |   |
              |_|   |
                    |
                    |
              -------------