             -------~
             |      |
           ~---~    |
          /     \   |
          \     /   |
         __-----__  |
        / /|   |\ \ |
        |_||   ||_| |
           |___|    |
           / _ \    |
          | | | |   |
          | | |_|   |
              (__)  |
                    |
              -------------